M
8
...o$oo.
o..oooo.
...ooo..
........
....oo..
....o...
...oo...
..o...@.
